0000000000
0111111110
0111111110
0000011110
0111011110
0101011110
0101011010
0101011010
0101111330
0000000000
