0000000000
0111131110
0101021110
0133021110
0103221110
0102201110
0100301110
0101111110
0101111110
0000000000
